3 13 31
%%%%%%%%%%%%%%%%%%%%%%%%%%%%%%%
%p    * **    *   2   1   *  p%
% # # #*# # # # # # # # # # # %
%   *  ** * *  *   * ** 2 *   %
% # # # # #*# # # # # # #*# # %
%* f * *    *b* * 1 **        %
% # # # # # # # # # # # # #*# %
%   5*     *x*  3   *    **  1%
% #*# # #*#*#*#*# # #1# # #*# %
%    *   * 1 * * 2  *   *  *  %
%*# # # # # # # # # # #*# # #*%
%p  *  * **    ** *** 1   *  p%
%%%%%%%%%%%%%%%%%%%%%%%%%%%%%%%